Waypoint Conversation Template
An Interactive Cliche by Josh Giesbrecht
Release 1 / Serial number 161118 / Inform 7 build 6M62 (I6/v6.33 lib 6/12N) SD

Blank Room
You can see a Boring Man and a Lovely Woman here.

>quit
Are you sure you want to quit?

* * *

Waypoint Conversation Template
An Interactive Cliche by Josh Giesbrecht
Release 1 / Serial number 161118 / Inform 7 build 6M62 (I6/v6.33 lib 6/12N) SD

Blank Room
You can see a Boring Man and a Lovely Woman here.

>say hello
(to yourself)
There is no reply.

* * *

Waypoint Conversation Template
An Interactive Cliche by Josh Giesbrecht
Release 1 / Serial number 161118 / Inform 7 build 6M62 (I6/v6.33 lib 6/12N) SD

Blank Room
You can see a Boring Man and a Lovely Woman here.

>talk about stuff
That's not a verb I recognise.

>hello
That's not a verb I recognise.

>say hello
(to yourself)
There is no reply.

* * *

Waypoint Conversation Template
An Interactive Cliche by Josh Giesbrecht
Release 1 / Serial number 161118 / Inform 7 build 6M62 (I6/v6.33 lib 6/12N) SD

Blank Room
You can see a Boring Man and a Lovely Woman here.

>say hi
That's not a verb I recognise.

>mention greeting
That's not a verb I recognise.

>mention this
That's not a verb I recognise.

>verbs
That's not a verb I recognise.

>mention greeting
That's not a verb I recognise.

* * *

Waypoint Conversation Template
An Interactive Cliche by Josh Giesbrecht
Release 1 / Serial number 161118 / Inform 7 build 6M62 (I6/v6.33 lib 6/12N) SD

Blank Room
You can see a Boring Man and a Lovely Woman here.

>say greetings
You stumble over that unfamiliar term and it just comes out a birdlike cry.

*** Run-time problem P10: Since the Boring Man is not allowed the property "active", it is against the rules to try to use it.

* * *

Waypoint Conversation Template
An Interactive Cliche by Josh Giesbrecht
Release 1 / Serial number 161118 / Inform 7 build 6M62 (I6/v6.33 lib 6/12N) SD

Blank Room
You can see a Boring Man and a Lovely Woman here.

>say greeting
"Hey!" you say. "Greeting! Greeting!"

You continue to focus on the topic at hand, but the Boring Man dismisses you.

>say weather
"Hey!" you say. "Weather!"

"Lovely weather we've had, isn't it?" says the man.

"Yes, fantastic, I suppose, hmm," replies the woman, obviously disinterested.

>say name
"Hey!" you say. "Name!"

>say hmm
You stumble over that unfamiliar term and it just comes out a birdlike cry.

>say greeting
"Hey!" you say. "Greeting!"

>say something
You stumble over that unfamiliar term and it just comes out a birdlike cry.

>restart
Are you sure you want to restart?

>y
Waypoint Conversation Template
An Interactive Fiction by Josh Giesbrecht
Release 1 / Serial number 161108 / Inform 7 build 6M62 (I6/v6.33 lib 6/12N) SD

Blank Room
You can see a Boring Man here.

>say name
"Hey!" you say. "Name! Name!"

"So, um, what's your name?" asks the man. "Grenelda," replies the woman. "Oh, um, that's, lovely," he stammered, then cursed himself under his breath.

* * *

Waypoint Conversation Template
An Interactive Cliche by Josh Giesbrecht
Release 1 / Serial number 161118 / Inform 7 build 6M62 (I6/v6.33 lib 6/12N) SD

Blank Room
You can see a Boring Man and a Lovely Woman here.

>x man
You see nothing special about the Boring Man.

>x woman
You see nothing special about the Lovely Woman.

"Lovely weather we've had, isn't it?" says the man.

"Yes, fantastic, I suppose, hmm," replies the woman, obviously disinterested.

* * *

Waypoint Conversation Template
An Interactive Cliche by Josh Giesbrecht
Release 1 / Serial number 161118 / Inform 7 build 6M62 (I6/v6.33 lib 6/12N) SD

Blank Room
You can see a Boring Man and a Lovely Woman here.

>suggest name
That's not a verb I recognise.

>say name
"Hey!" you say. "Name!"

"So, um, what's your name?" asks the man. "Grenelda," replies the woman. "Oh, um, that's, lovely," he stammered, then cursed himself under his breath.